p	p
p‘	ph
b	b
m	m
t	t
t‘	th
d	d
n	n
k	k
k‘	kh
g	g
ŋ	ng
ts	ts
ts‘	tsh
dz	dz
s	s
z	z
ʔ	
x	x
ɣ	h
j	j
l	l
ɲ	ny
tr	tr
tr‘	trh
dr	dr
nr	nr
tʂ	tsr
tʂ‘	tsrh
dʐ	dzr
ʂ	sr
ʐ	zr
tɕ	tsy
tɕ‘	tshy
ʑ	zy
ɕ	sy
dʑ	dzy
w	w
