p	p
p‘	p‘
b	b‘
m	m
t	t
t‘	t‘
d	d‘
n	n
k	k
k‘	k‘
g	g‘
ŋ	ng
ts	ts
ts‘	ts‘
dz	dz‘
s	s
z	z
ʔ	ˑ
x	χ
ɣ	ɣ
j	i̯
l	l
ɲ	ńź
tr	tˆ
tr‘	tˆ‘
dr	dˆ‘
nr	ń
tʂ	tṣ
tʂ‘	tṣ‘
dʐ	dẓ‘
ʂ	ṣ
ʐ	dẓ‘
tɕ	tś
tɕ‘	tś‘
ʑ	dź‘
ɕ	ś
dʑ	ź
w	i̯u
