a	ak aj ang ɨ ij e
o	ok ong aw a an ak
ak	awk ok a aj ɨk ang
e	ij et ak a aj
am	ɨm ap
aj	an ɨj e at
an	at aj e ɨn eng
eng	in an ang et e
at	ɨt ek e aj ang
aw	awk o a am
ɨng	ang ɨ ɨk
ung	
ɨt	at ɨ ɨk ɨn ɨj ij ik
u	aw uk ɨ ɨj
ɨp	ap ɨm ɨt
ang	a eng ɨng ak
ong	ok
ɨ	a ɨk ɨj ij ɨng u ung
ɨm	ɨp u
ɨj	al ɨ ɨn ɨng ɨt u
ij	e ɨj
ɨn	an ɨj ij ɨt
in	ɨn eng ɨng ɨj it
ɨk	ɨt ik uk
uk	ɨk u
it	ɨk ing
ap	at am ak ɨp o a
awk	o ak aw uk ok
et	
ok	o ak awk ong a
-	
	
