âg	âk â âng ǝg ieg ǝr
ug	uk ung og â ân âk
âk	ok uk âg â ǝk âng
ieg	ǝr iek âk âg â
âm	ǝm âp
â	ân ǝr ieg ât
ân	ât â ieg ǝn ieng
ieng	ien ân âng iek ieg
ât	ǝt iek ieg â âng
og	ok ug âg âm
ǝng	âng ǝg ǝk
ông	
ǝt	ât ǝg ǝk ǝn ǝr iet
ôg	og ôk ǝg ǝr
ǝp	âp ǝm ǝt
âng	âg ieng ǝng âk
ung	uk
ǝg	âg ǝk ǝr ǝng ôg ông
ǝm	ǝp ôg
ǝr	â ǝg ǝn ien ǝt ôg
ǝr	ieg
ǝn	an ǝr ǝt
ien	ǝn ieng ǝng ǝr iet
ǝk	ǝt iet ôk
ôk	ǝk ôg
iet	ǝk ien
âp	ât âm âk ǝp ug âg
ok	og âk og ôk uk
iek	
uk	ug âk ok ung âg
-	
